7 16 40
****************
*D****S*********
*********_____M*
**_********S****
**___***********
********_____M**
****************