8 13 100
*************
*D********S**
***********M*
**____*_____*
**S*S****S***
***********M*
**_M________*
*************