18 18 250
******************
*****SSSSSS*******
****S******S******
***S********S*****
**S**********S****
******************
*M______________M*
******_***_*******
**S***_*D*_****S**
******_***_*******
*M______________M*
******************
******************
******************
*****GGGGGGGG*****
******************
******************
******************